中文名称	英文名称	三字母缩写	单字母符号
甘氨酸	Glycine	Gly	G
丙氨酸	Alanine	Ala	A
缬氨酸	Valine	Val	V
亮氨酸	Leucine	Leu	L
异亮氨酸	Isoleucine	Ile	I
脯氨酸	Proline	Pro	P
苯丙氨酸	Phenylalanine	Phe	F
酪氨酸	Tyrosine	Tyr	Y
色氨酸	Tryptophan	Trp	W
丝氨酸	Serine	Ser	S
苏氨酸	Threonine	Thr	T
半胱氨酸	Cystine	Cys	C
蛋氨酸	Methionine	Met	M
天冬酰胺	Asparagine	Asn	N
谷氨酰胺	Glutarnine	Gln	Q
天冬氨酸	Asparticacid	Asp	D
谷氨酸	Glutamicacid	Glu	E
赖氨酸	Lysine	Lys	K
精氨酸	Arginine	Arg	R
组氨酸	Histidine	His	H
